s s s s s s s s s s s s s s s s s s s s s s s s s s s s s s s s s s s s s s s s s s s s s s s s s s s s s s s s s s s s s s s s s s s s s s s s s s s s s s s s s s s s s s s s s s s s s s s s s s s s s s s s s s s s s s s s s s s s s s s s s s s s s s s s s s s s s s s s s s s s s s s s s s s s s s s s s s s s s s s s s s s s s s s s s s s s s s s s s s s s s s s s s s s s s s s s s s s s s s s s s s s s s s s s s s s s s s s s s s s s s s s s s s s s s s s s s s s s s s s s s s s s s s s s s s s s s s s s s s s s s s s s s s s s s s s s s s s s s s s s s s s s s s s s s s s s s s s s s s s s s s s s s s s s s s s s s s s s s s s s s s s s s s s s s s s s s s s s s s s s s s s s s s s s s s s s s s s s s s s s s
s s s s s s s s s s s s s s s s s s s s s s s s s s s s s s s s s s s s s s s s s s s s s s s s s s s s s s s s s s s s s s s s s s s s s s s s s s s s s s s s s s s s s s s s s s s s s s s s s s s s s s s s s s s s s s s s s s s s s s s s s s s s s s s s s s s s s s s s s s s s s s s s s s s s s s s s s s s s s s s s s s s s s s s s s s s s s s s s s s s s s s s s s s s s s s s s s s s s s s s s s s s s s s s s s s s s s s s s s s s s s s s s s s s s s s s s s s s s s s s s s s s s s s s s s s s s s s s s s s s s s s s s s s s s s s s s s s s s s s s s s s s s s s s s s s s s s s s s s s s s s s s s s s s s s s s s s s s s s s s s s s s s s s s s s s s s s s s s s s s s s s s s s s s s s s s s s s s s s s s s s
s s s s s s s s s s s s s s s s s s s s s s s s s s s s s s s s s s s s s s s s s s s s s s s s s s s s s s s s s s s s s s s s s s s s s s s s s s s s s s s s s s s s s s s s s s s s s s s s s s s s s s s s s s s s s s s s s s s s s s s s s s s s s s s s s s s s s s s s s s s s s s s s s s s s s s s I s s s s s s s s s s s s s s s s s s s s s s s s s s s s s s s s s s s s s s s s s s s s s s s s s s s s s s s s s s s s s s s s s s s s s s s s s s s s s s s s s s s s s s s s s s s s s s s s s s s s s s s s s s s s s s s s s s s s s s s s s s s s s s s s s s s s s s s s s s s s s s s s s s s s s s s s s s s s s s s s s s s s s s s s s s s s s s s s s s s s s s s s s s s s s s s s s s s s s s s s s s s s s s s s s
s s s s s s s s s s s s s s s s s s s s s s s s s s s s s s s s s s s s s s s s s s s s s s s s s s s s s s s s s s s s s s s s s s s s s s s s s s s s s s s s s s s s s s s s s s s s s s s s s s s s s s A A s s s s s s s s s s s s s s s s s s s s s s s s s s s s s s s s s s s s s s s s s s s s s s s s s s s s s s s s s s s s s s s s s s s s s s s s s s s s s s s s s s s s s s s s s s s s s s s s s s s s s s s s s s s s s s s s s s s s s s s s s s s s s s s s s s s s s s s s s s s s s s s s s s s s s s s s s s s s s s s s s s s s s s s s s s s s s s s s s s s s s s s s s s s s s s s s s s s s s s s s s s s s s s s s s s s s s s s s s s s s s s s s s s s s s s s s s s s s s s s s s s s s s s s s s s s s s s s s s
s s s s s s s s s s s s s s s s s s s s s s s s s s s s s s s s s s s s s s s s s s s s s s s s s s s s s s s s s s s s s s s s s s s s s s s s s s s s s s s s s s s s s s s s s s s s s s s s s s s s s s s s s s s s s s s s s s s s s s s s s s s s s s s s s s s s s s s s s s s s s s s s s s s h h h h b h h h s s s s s s s s s s s s s s s s s s s s s s s s s s s s s s s s s s s s s s s s s s s s s s s s s s s s s s s s s s s s s s s s s s s s s s s s s s s s s s s s s s s s s s s s s s s s s s s s s s s s s s s s s s s s s s s s s s s s s s s s s s s s s s s s s s s s s s s s s s s s s s s s s s s s s s s s s s s s s s s s s s s s s s s s s s s s s s s s s s s s s s s s s s s s s s s s s s s s s s s s s s s s a a
s s s s s s s s s s s s s s s s s s s s s s s s s s s s s s s s s s s s s s s s s s s s s s s s s s s s s s s s s s s s s s s s s s s s s s s s s s s s s s s s s s s s s s s s s s s s s s s s s s s s s s s s s s s s s s s s s s s s s s s s s s s s s s s s s s s s s s s s s s s s s s s s s s s s s s s s s s s s s s s s s s s s s s s s s s s s s s s s s s s s s s s s s s s s s s s s s s s s s s s s s s s s s s s s s s s s s s s s s s s s s s s s s s s s s s s s s s s s s s s s s s s s s s s s s s s s s s s s s s s s s s s s s s s s s s s s s s s s s s s s s s s s s s s s s s s s s s s s s s s s s s s s s s s s s s s s s s s s s s s s s s s s s s s s s s s s s s s s s s s s s s s s s s s s s s s s s s s s s s s a a
s s s s s s s s s s s s s s s s s s s s s s s s s s s s s s s s s s s s s s s s s s s s s s s s s s s s s s s s s s s s s s s s s s s s s s s s s n s s s s s s s s s s s s s s s s s s s s s s s s s s s s s s s s s s s s s s s s s s s s s s s s s s s s s s s s s s s s s s s s s s s s s s s s s s s s s s s s s s s s s s s s s s s s s s s s s s s s s s s s s d s s s s s s s s s s s s s s s s s s s s s s s s s s s s s s s s s s s s s s s s s s s s s s s s s s s s s s s s s s s G G s s s s s s s s s s s s s s s s s s s s s s s s s s s s s s s s a s s s s s s s s s s s s s s s s s s s s s s s s s s s s s s s s s s s s s s s s s s s s s s s s s s s s s s s s s s s s s s s s s s s s s s s s s s s s s s s s s s s a s a a
s s s s s s s s s s s s s s s s s s s s s s s s s s s s G G s s s s s s s s s s s s s s s s s s s s s s s s s s s A s s s s s s s s s s s G G s s b s s s s s s s s A s s s s G G s s A s s s s s G G s s s s s s s s s s s s s s s s s s s s s s s s s s s s s s s s s s s s s s s s s s s s s s s s s s s s s s s s s s s s s s s s s s s s s s s s s s s s s s h h b h h h h h s s s s s s s s s s s s s s s s s s s s s s s s s s s s s s s A A s s s s s s s s s s s s s s s s s G G s s p p s s s s s s s s s s s s s s s s s s s s s s s s s s s s s s s a a s s A A s s s s s s A s s s s A s s s s s s s s s s s s s s s s s s s A A s s s A A s s s s s s s s s s s s s s s s s s s s s s s s s s s s s s s s s s s s s s s s s a s a a
s s s s s s s s s s s s s s s s s s s s s s s s s s s s p p s s s s s s s s s s s s s s s s s s s s s s s s s s s s s s s s s s s s s s s p p s s s s G G s s s s s s s s s s p p s s s s s s s s p p s s s s s s s s s s s s s s s s s s s s s s s s s s s s s s s s s s G G s s s s s s s s s s s a s s s s b s s s s a s s s s s s m s s s s s s s s s s s s s s s s s s s s s s s s s s s s s s s s s s s s s s s s s s s s s s s s s s s s s s s s s s s s s s s s s s s G G s s p p s s p p s s s s s s s s s s s s s s s s s s s s s s s s s s s s s s a a a s s s s s s s s s s s s s s s s s s s s s s s s s s s s s s s s s s s s s s s s s s s s s s s s s s s s s s s s s s s s s s s G G s s s s s s s s s s s s s s s s a s a s a a
s s s s s s s s s s s s s s s s s s s s s s s s s s s s p p s s s s s s s s s s s s s s s s s s s s s s s s s s s s s s s s s s s s s s s p p s s s s p p s s s s s s s s s s p p s s s s s s s s p p s s s s s s s s s G G s s s s s s s s s s s s s s s s s s s s s s s p p s s s s s s s s s s s a s s s s s Q s s s a s s s s s s s G s s s s s s s s s s s s s s s s s s s s s s s s s s s s s s s s s s s s s s s s s s s s s s s s s s s s s s s s s s s s s s s s s s p p s s p p s s p p s s s s s s s s s s s s s s s s s s s s s s s s s s s s s a a a a s s s s s s s s s s s s s s s s s s s s s s s s s s s s s s s s s s s s s s s s s s s s s s s s s s s s s s s s s s s s s s s p p s s s s s s s s s G G s s s s s a s a s a a
s s s s s s s s s s s s s s s s s s s s s s s s s s s s p p s s s s s s s s s s s s s s s s s s s s s s s s s s s s s s s s s s s s s s s p p s s s s p p s s s s s s s s s s p p s s s s s s s s p p s s s s s s s s s p p s s s s s s s s s s s s s s s s s s s s s s s p p s s s s s s s s s s s a s s s s s Q s s s a s s s s s s s s s s s s s s s s s s s s s s s s s s s s s s s s s s s s s s s s s s s s s s a s s s s s s s s s s s s s s s s s s s s s s s s s s s p p s s p p s s p p s s s s s s s s s s s s s s s s s s s s s s s s s s s s a a a a a s s s s s s s s s s s s s s s s s s s s s s a s s s a s s s s s s s s s s s s s s s s s s s s s s s s s s s s s s s s s s s s p p s s s s s s s s s p p s s s a s a s a s a a
s s s s y s s s s s s s s s s m s s s s s s s s m s s s p p s s s s s m s s s s s s s s s s s s s s s O s s s s s s s s s I s n s s s s s p p s s a s p p s s s s s s s s s s p p s s s s s s s s p p s s I s m s s s s p p O s s s s s Q I s s s s s e s s s s s s s s s p p s s s s s n I s n s s a s s s s s s s s s a s s s s s s s s s s s s s s s s s s s s s s s s s s s s s s s s s s s s s s s s s s s e s s a s s s s s s s s s s s s s s s s s s s s s s s I s s s p p s s p p s s p p s s s m s s s s s s I s s s m s s s s s s s s m s s s a a a a a a s m s s s s s s s s s s s s s s s s s s s s a p s s a s s s s s s s s s s s s s s s s s s s s s s s s s s s s s s s Q s q s s p p s s s s s s s s s p p s s s a s a s a s a a
v v v v v v v v v v v v v v v v v v v v v v v v v v v v v v v v v v v v v v v s v s v v s v v s v v s v v v v v v v v v v v v v v v v v v v v v v v v v v v v v v v v v v v v v v v v v v v v v v v v v v v v v v v v v v v v v v v v v v v v v v v v v v v v v v v v v v v v v v v v v v v v v v v v v v v v v v v v v v v v v v v s v s v v s v s v v s v v v v v v v v v v v v v v v v v s v s v s v v v v v v v v v v v v v v v v v v v s s s s s s v v v v v v v v v v s v v s s v v s s v v v v v v v v v v v v v v v v v v v v v v v v v v v v v v v v v v v v v v v v v v v v s s s v v s s s v v v v v v v v v v v v v v v v s s s s s v s s s s v v v v v v v v v v v v v v v v v v v v v v v v v v v v v v v v v v v s v s v s v s v v

