s s s s s s s s s s s s s s s s s s s s s s s s s s s s s s s s s s s s s N n s s s s s s s s s s s s s s s s s s s s s s s s s s s s s s s s s s s s s s s s s s s s s s s s s s s s s s s s s s s s s s s s s s s s s s s s s s s s s s s s s s s s s s s s s s s s s s s s s
s s s s s s s s s s s s s s s s s s s s s s s s s s s s s s s s s s s s s s q s s s s s s D D D D D D s s s N s s s s s s s s s s A A A s s s s s s s s s D D D D D D D s s s s D D D D s s s s s s s D D D D D D s s s s s s s s s s s s s s s s s s s s s s s s s s s s s s s
s s s s s s s s s s s s s s N I s s s s s s s s s s s s s s s H s s s s s s s s s s s s s s s s s s s s A s s s s s s s s s s s m M M M s s s s s s s s s s s s s s s s s s s s s s s s s s s s s s s s s s s s s s s s s s s I I s s s s s s s s s s s s s s s s s s s s s s s
N I s s s s s s s s s s s s s A A A s s s s s s s s s M M M s D s s s s s s s s D s s s s s s D I I s s s s s s s D D D s s s s s s N s I e s s s s s s s s s s s s s s s s s s s s s s s s s N I m s A s s s s s s s s s s s s s s s s s s s s s s s s s s s s s s s s s s s s
s s s s s s s s s s s s s s M M M M M s s s s s s s s s N s s s s s M M M M M s s s s D D D s s s s s s s s s s s D D D s s s s s s N s s M M M M M s D D D s s s s s s s s D D D s s s s D s N s D D D s s s s s s s s s s s s s s s s s s s s s s s s s s s s s s s H D D s s
s s s s s s s s s s s s s s s s N s s s s s s N s s s s N s s s s D s s N s s s s s s s N s s s s s s s s D D D s s s s s s A A A s N N s s s N s s s s s s s N s s s s s s s s s s s s s s s s s s s s s s s s s s s s s s s s M M M s s s s s s s s s s N s s s s s s s s s s
s s s D D s s s s s s s s s s s N s s s s H s I s s s s N s s s s s D s N s s s s s s A s s s s s s s s G s s s s s s s s s M M M s N s s s s N s s s s s s s s s N N I s s s s s s s A s s s s s s s s s s s s s s s s s s s s s N s s s s s s D D D s s s s s s s I s s s s s
s s s s s s m s s s s s s s s s N s s A A A A A s s s s N s s I I s s s N s s s s s s s s s M M M s D D D I s s s s s s s s s N s s N s A s s N s s s s s s s I s s s s s s s s s s s s s s s s s s s s s I I s s s s s A A A A A N s s s s s s s s s s s s s N N N s s s s s s
s s s s s s s s s s s s s s s s N s M M M M M M M s s s N s s s s s s s N s s M M M s s s s s N s s s s s s s s s s s s s s s N s s N M M M s N s s s s s s s M M M s D D D s s s s s D D D s s s s s s s s s D D D s s M M M M M N s s s s s s s s s s s s D D D s s s s s s s
s s s s s s s s s s s s s s s s s s s s s N s s s s s s N s N s s s s s N s s s N s s s s s s N s s s s s s s s s s s s s s s N s s N s N s s N s s s s s s s s N s s s s s s s s s s s s s s s s s s s M M M s s s s s s s N s s N s s s s s s s s s s s M M M M M s s s N s s
s s s s s s s s s s s s s s s s N s s s s N s s s s s s N s s s B A A A N s s s N s s s s s s N s s s s s s s s s s s s s s s s G s N N N s s N s s N s s s s s N s s s s s s s s s s s s s M M M s s s s N s s s s s s s s N s s N s s s s s s s s s s s s s N s s s s s s s s
s s s s y s s s s s s s s s s s N s s s s N s s s s s s N s s M M M M M M M s s N s N s s s s N s s s s s s s s s s s s s s s N A s N s N s s s N I s s s s s s N s s s s s s s s s N m s s s N s s s s s N s s s s s s s s N s s N s s N s s s N s s s s s s s s s s s s s s s
v v v v v v v v v v s M M M M M N s s s s N s s s s s s N s s s s s N s N s s s N s s s s s s N s s s s s s s s s s s s M M M M M s N s N s s N s s s s s s s s N s s s s s s s s s s s s s s N s s s s s N s s s s s s s s N s s N s s M M M M M M M s s s s N s s s s s s s s

