s s s s s s s s s s s s s s s s s s s s s s s s s s s s s s s s s s s s s s s s s s s s s s s s s s s s s s s s s s s s s s s s s s s s s s s s s s s s s s s s s s s s s s s s s s s s s s s s s s s s s s s s s s s s s s s s s s s s s s s s s s s s s s s s s s s s s s s s s s s s s s s s s s s s s s s s s s s s s s s s s s s s s s s s s s s s s s s s s s s s s s s s s s s s s s s s s s s s s s s s s s s s s s s s s s s s
s s s s s s s s s s s s s s s s s s s s s s s s s s s s s s s s s s s s s s s s s s s s s s s s s s s s s s s s s s s s s s s s s s s s s s s s s s s s s s s s s s s s s s s s s s s s s s s s s s s s s s s s s s s s s s s s s s s s s s s s s s s s s s s s s s s s s s s s s s s s s s s s s s s s s s s s s s s s s s s s s s s s s s s s s s s s s s s s s s s s s s s s s s s s s s s s s s s s s s s s s s s s s s s s s s s s
s s s s s s s s s s s s s s d d s s s s s s s s s s s s s s s s s s s s s s s s s s s s s s s s s s s s s s s s s s s s s s d d s s s s s s s s s s s s s s s s s s s s s s s s s s s s s s s s s s s s s s s s s s s s s s d d s s s s s s s s s s s s s s s s s s s s s s s s s s s s s s s s s s s s s s s s s s s s s s d d s s s s s s s s s s s s s s s s s s s s s s s s s s s s s s s s s s s s s s s s s s s s s s d d s s s s
d s s s s s s s s s s s s s s s s s s s s s s s s s s s s s s s s s s s s s s s s s s s s s s d d s s s s s s s s s s s s s s s s s s s A A s s s s s s s s s s s s s s s s s s s s s s s s s d d n s s s s s s s s s s s s s s s s s s s s s s s s s s s s s s s s s s s s s s s s s s s s s d d s s s s s s s s s s s s s s s s s s s s s s s s s s s s s s s s s s s s s s s s s s s s s s d d s s s s s s s s s s s s s s s s s s s
s s s s s s s s s s s s s s s s s s s s s s s s s s s s s s s A A A A s s s s s s s s s s s s s s s A s A s A s m I s s s s s s s s s A s s A s s s s s I I s s s s s s s s s s s s s s A A A s s q s s s s s A A A s s s s s s s s s s s s s s s s s s s s s s A A A A A A s s s s s s s s s s s s s s s s s s s s s s s s s s s s s s s s s s s s s s s s s s s s s s I I s s s s s s s s s s s s s s s s s s s s s s s s s s s s a a
s s s s s s s s s s s s s s s s s s s s s s I s s s s s s s s s s s s s s s s s s s s s s s s s s s s A s A s s s s s s s s s s s s s s s s s s s s s s s s s s s s s s s s s s s s s s J s s s s s s s s s s s s s s s s s s s s s s s s s m m s s s s s s s s s s s s s s I I s s s s s s s s s s s s I s s s s s s s s s s s s s s s s s s s A A A A A s s s s s s s s s s s s s s s s s s s s s s s s s s s s s s s s s s s s a a a
s s s s s s s s s s s s s s s s s s s s s s s s s s s s s s s s s s d s s s s s s s s s s s s s s s s s s s s s s s s s s s s s s s s s s s s s s s s s s s s s s s d s s s s s s s s s I s s s s s s s s s s s s s s s s s s s s s s s s s s s s s s s s s s s s s d s s s s s s s s s s s s s s s s s H s s s s s s s s s s s s s s s s s s s s s s I s s s s s s d s s s s s s s s s s s s s s s s s s s s s s s s s s s s s a a a a
s s s s s d s s s s s s s s s s s s s s s s s s s s s s s s s d s s s s s s s s s s s I s s s s s s s s s d s s s s s s s s s s I s s s s s s s s s s s s s s d s s s s s s s s s s s s s s s J J J J J s d s s s s s s s s s s s s s s s s s s s s s s s s s d s s s s s s s s s s s s s s s s A A A A s d s s s s s s s s s s s s s s s s s s s s s s s s s d s s s s s s s s s s s s s s s s s s s s s d s s s s s s s s s a a a a a
s s s s s s s s s s J J J J J J J J J J J J J J J J s J J J J J J J J J J J J J J J s J J J J J J J J J J J J J J J s s s s s s J J J J J J J J J J s s s s s s J J J J J J J J J J s s s s a K K K K K a s s s s s s s s s s s s s s s s J J J s s s J J J J J J J J J J J J J J J s s s s s s s s s s s s s s s s s J J J J J J J J s s s J J s s J J s s J J s s s J J J J J J J J J s s s s s s s s s s s s s s s s s s a a a a a a
s s s s s s s a a a K K K K K K K K K K K K K K K K a K K K K K K K K K K K K K K K a K K K K K K K K K K K K K K K a s s s s a K K K K K K K K K K a s s s s a K K K K K K K K K K a s s s a s s s s s a s s s s s s s m s s s s s s s s K K K s s a K K K K K K K K K K K K K K K a s s s s s s s s s s s s s s s a K K K K K K K K a s s K K s s K K s s K K s s a K K K K K K K K K a a s s s s s s s s s s s s s s s a a a a a a a
s s s s s s a a a a s s I s s s s s s s s s s s s s a s s s I s s s s s s s s s s s a s s s s s s s s s s s s s s s a s s s s a s s s s s s s s s s a s s s s a s s s s s s s s s s a s s s a s s s s s a s s s s s s s s s s s s s s s s s s s s s a s s s s s s s m m s s s s s s a s s s J J J J J J J J s s s s a s s s s m s s s a s s s s s s s s s s s s s s a s s s s s s s s s a a a s s s s s s s s s s s s s a a a a a a a a
s s s s y a a a a a s s s s s s s s s s s s s s d s a s s s s s s s s s s s s s s s a s s s s s s s s s s s s s s s a s s s s a s s s s s s s s d s a s s s s a s s s s s s s s s s a s s s a s s s s s a I s s s s s s s s s s s s s s s s s s d s a s s s s s s s s s s s s s s s a s s a K K K K K K K K a s s s a s s s s s s s s a s s s s d s s s s s s s s s a s s s s s s s d s a a a a s s s s s s s s s s s a a a a a a a a a
v v s E E E E E E E E s s s s s s s s s s s s s s s a s s s s s s s s s s s s s s s a s s s s s s s s s J s s s s s a s s s s a s s s s s s s s s s a s s s s a s s s s I s s s s s a s s s a s s s s s a s s s s s s E E E E E E E E s s s s s s s a s s s s s s s s s s s s s s s a s s a s s s s s s s s a s s s a s s s s s s s s a s s s s s s s s s s s s s s a s s s s s s s s E E E E E E E E E E E E E s s v v v v v v v v v v

