s s s s s s s s s s s s s s s s s s s s s s s s s s s s s s s s s s s s s s s s s s s s s s s s s s s s s s s s s s s s s s s s s s s s s s s s s s s s s s s s s s s s s s s s s s s s s s s s s s s s s s s s s s s s s s s s s s s s s s s s s s s s s s s s s s s s s s s s s s s s s s s s s s s s s s s s s s s e s s s s s s s s s s s s s s s s s s s s s s s s s s s s s
s s s s s s s s s s s s s s s s s s s s s s s s s s s s s s s s s s s s s s s s s s s s s s s s s s s s s s s s s s s s s s s s s s s s s s s s s s s s s s s s s s s s s s s s s s s s s s s s s s s s s s s s s s s s s s s s s s s s s s s s s s s s s s s s s s s s s s s s s s s s s s s s s s s s s s s s s s s s s s s s s s s s s s s s s s s s s s s s s s s s s s s s s
s s s s s s s s s s s s s s s s s s s s s d s s s s s s s s s s s s s s s s s d s s s s s s s s s s s s s s s s s s s s s s s s s s s s s d s s s s s s s s s s s s s s s s s d s s s s s s s s s s s s s s s s s s s s s s s s s s s s s d s s s s s s s s s s s s s s s s s d s s s s s s s s s s s s s s s s s s s s s s s s s s s s s d s s s s s s s s s s s s s s s s s a a
s s s s s s s s s s s s d s s s s s s s s n s s d d s s s s s s s s s s s s s s s s d d s s s s s s s s s s s s s s s s d s d s s s s s s s s s d d s s s s s s s s s s s s s s s s d d s s s s s s s s s s s s s s s s d s s s s s s s s s n s d d s s s s s s s s s s s s s s s s d d s s s s s s s s s s s s s s s s d s s s s s s s s n s s d d s s s s s s s s s s s s s a a
s s s s s s s s s s s s s s s s s s s s s b h h h s s s s s s s s s s s s s s s s s s s s s q q q q q s s s s s s s s s s s b h h h s s s s s s s s h h b h h s s s s s s h h h h s s s s s s s s s s s s s s s s s s s s s s s s s s s s s b h h h s s s s s s s s s s s s s s s s s s s s s s s s s s s s s s s s s s s h h h h h s s s b s s s s s s s s s s s s s b s s s a a
s s s s s s s s s s s s s s s s s s s s s s s s s s s s s s s s s s s s s s s s s s s s s s s s s s s s s s s s s s s s s s s s s s s s s s s s s s s s s s s s s s s s s s s s s s s s s s s s s s s s s s s s s s s s s s s s s s s s s s s s s s s s s s s s s s s s s s s s s s s s s s s s s s s s s s s s s s s s s s s s s s s s s s s s s s s s s s s s s s s s s s s a a
s s s s s s s s s s s s s s s s s s s s s s s s s s s s s s s s s s s s s s s s s s s s s s s s s s s s s s s s s s s s s s s s s s s s s s s s s s s s s s s s s s s s s s s s s s s s s s s s s s s s s s s s s s s s s s s s s s s s s s s s s s s G G s s s s s s s s s s s s s s s s s s s s s s s s s s s s s d s s s s s s s s s s s s s s s s s s s s s s s s s s s s a a
s s s s s s s s s n s s s s s s s a s s s s s s s s s s s s s s s s s s s s s G G s s s s s n s s s s s s s s s s s s s s s s s s s s G G s s s s s s s s s s s s s s s s s s s s s s s s s s s G G s s s s s s s s s s s s s s s s s G G s s s s s s p p s s s s s s s s s s s s s s s s s s s s s s s s s s s s s G s s s s s s s s s s s s s s s s s s s s s s s s s s s s a a
s s s s s s s s h b h s s s s D a a s s s b s s s s s a s s s s s s s s s s s p p s s s s B q q q q q s s s s s s s s s s h s s s s s p p s s s q q q q s s q q q s s s s s s s s s s s s s s s p p s s s s s s s s s s s s s s s s s p p s s G G s s p p s s s s s s s s s s s s s s s s s s s s s s s s s s s s s b s s m s s s s B q s s s s s G G s s s s s s s h h s s s a a
s s s s s s s s s s s s s s s a a a s s s s s s s s s a s s s s s s s s s s s p p s s s s s s s s s s s s s s s s s s s s s s s s s s s p s s s s s s s s s s s s s s s s s s s s s s s s s s s p p s s s s s s s s s s G G s s s s s p p s s p p s s p p s s s s s s s s s s s s s s s s s s s s s s a s s s s s s s s s s s s s s s s s s s s s p p s s s s s s s s s s s s a a
s s s s s s s s s s s s s s a a a a s s s s s s s s s a a s s s s s s s s s s p p s s s s s s s s s s s s s s s s s s s s s s s s s s s p s s s s s s s s s s s s s s s s s s s s s s s s s s s p p s s s s s s s s s s p p s s s s s p p s s p p s s p p s s s s s s s s s s s s s s s s s d s s s s a s s s s s s s s s s s s s s s s s s s s s p p s s s s s s s s s s H s a a
s s s s y s s s s s s s s a a a a a s s s s s e s s s a a s s m s s s s s s s p p s s s s s s s s s s s s m s s s n s m m m m s s s s s p s s s s s s s n m m n s s s s s s s s s s s s d s s s p p s s s s s s s s s s p p s m s s s p p s s p p s s p p s s s s s s s s s s s s s s s s s s s s s s a s s s s s s s s s s s s s s s s s s s s s p p q s s s s s s s s s H s a a
v v v v v v v v v v v v v v v v v v v v v v v v v v v v v v v v v v v v v v v v v v v v v v v v v v v v v v v v v v v v v v v v v v v v v v v v v v v v v v v v v v v v v s s s s v v v v v v v v v v s s s v v v v v v v v v v v v v v v v v v v v v v v v v v v v v v s s s v v v v v v v v v v s s v v v v v v v v v v v v v v v v v v v v v v v v v v v v v v v v v v v v v v

