s s s s s s s s s s s s s s s s s s s s s s s s s s s s s s s s s s s s s s s s s s s s s s s s s s s s s s s s s s s s s s s s s s s s s s s s s s s s s s s s s s s s s s s s s s s s s s s s s s s s s s s s s s s s s s s s s s s s s s s s s s s s s s s s s s s s s s s s s s s s s s s s s s s s s s s s s s s s s s s s s s s s s s s s s s s s s s s s s s s s s s s s s s s
s s s s s s s s s s s s s s s s s s s s s s s s s s s s s s s s s s s s s s s s s s s s s s s s s s s s s s s s s s s s s s s s s s s s s s s s s s s s s s s s s s s s s s s s s s s s s s s s s s s s s s s s s s s s s s s s s s s s s s s s s s s s s s s s s s s s s s s s s s s s s s s s s s s s s s s s s s s s s s s s s s s s s s s s s s s s s s s s s s s s s s s s s s s
s s s s s s s s s s s s s s s s s s s s s s s s s s s s s s s s s s s s s s s s s s s s s s s s s s s s s s s s s s s s s s s s s s s s s s s s s s s s s s s s s s s s s s s s s s s s s s s s s s s s s s s s s s s s s s s s s s s s s s s s s s s s s s s s s s s s s s s s s s s s s s s s s s s s s s s s s s s s s s s s s s s s s s s s s s s s s s s s s s s s s s s s s s s
s s s s s s s s s s s s s s s s A A A s s s s s s s s s s n s s s s s s s s s s s s s s s s s s s s s s s s s s s s s s s s s s s s s s s s s s s s s s s s s s s A A s s s s s s s s s s s s s s s s s s s s s s s s s s s s s s s s Q s s s s s s s s s s s s s s s s s s s s s s s s s s s s s s s s s s s m s s s s s s s s s s s s s s s A A s d s s s s s s s s s s s s s s s s
s s s s s s s s s s s s s s s s s s s s s s s s h h h h h b s s s s s s s s s s s s s s s s s s s s s s s s s s s s s s s s s s s s s s s s s s s s s s s s s s b h h s s s s s s s s s s s s s s s s s s s s s s s s s s s s s s h h h h h h h b s s s s s s s s s s s s s s s s s s s s s s s s s s s h h h h h s s s s s s s s s s s s s s h h h h s s s s s s s s s J s s s s a a
s s s s s s s s s s s s s s s s s s s s s s s s s s s s s s s s s s s s s s s s s s s s s s s s s s s s s s s s s s s s s s s s s s s s s s s s s s s s J s s s s s s s s s s s s s s s s s s s s s s s s s s s s s s s s s s s s s s s s s s s s s s s s s s s s s s s s s s s s s s s s s s s s s s s s s s s s s s s s s s s s s s s s s s s s s s s s s s s s s s s s s s s a a a
s s s s s s s s s s O O s s s s s s s s s s s s s s s s s s s s s s s s s s s s s s s s s s s s s s s s s s s s s s s s s s s s a a s s s s s s s s s s s s s s s s s s s s s s s s s s s s s s s s s s s s s s s s s s s s s s s s s s s s s s s s s s s s s s s s s s s s s s s s s s s s s s s s s s s s s s s s s s s s s s s s s s s s s s s s s s s s s s s s s s s s s s a a a
s s s s s s s s s s s s s s s s s s s s s s s s A A A s s s s s s s s s s s s s s s s s s s s s s s s s s s s s s s s s s s s a a a s s s s s s s s s s s s s s s s s s h h h s s s s s s s s s s s s s s s s s s s s s s s s s s s s s s s I s s s s s s s s s s s s s s s s s s s s s s s s s s s s s s s s s s s s s s s s s s s s n s s s s s s s s s s s s s s s s s s a s a a a
s s s s s s s s s s a a a a s s s s s s s s s s h h h h h h s s s s s s s s s s s s a a s s s s s s G G s s s s s s s s a s s a a a s s s s s s s q q q q q s b s s s s s s s s s s s s s s s s s s s s I s s s s s s s s s s s s h h h h h h h h s s s s s s s s s s s s s s s s s s s s s h h h s s s s s s s s s s s s s s s s s s b s s s s s s s s s s s s s s s s s a a s a a a
s s s s s s s s s a a s s s s s s s s s s s s s s s s s s s s s s Q I s s s s s s a a a s s s s s s p p s s s s s s m a a s s a a a s s s s s s s s s s Q I s s s s s s s s s s s s s s s s s s s s s s Q s s s s s s s s s G G s s s s s s s s s s s s a s s s s s s s s s s s s n s s s s s s s s s s s s s s s s s s s s s s s s s s s s s s G G s s s s s s s s s s s a a s a a a
s s s s s s s s a a a s s s s s s s s s H s s s s s s s s s s s s s s s s s s s a a a a a s s s s s p p s s s s s s a a a s s a a a s s s s s s s s s s s s s s s s s s s s s s s s s s s s s s s s s s O O s s s s s s s s p p s s s s s s s s s s s s a s s s s s s s s s s s b b s s s s s s s s s s s s s s s s s s s s s s s s s s s s s s p p s s s s s s s s s a s a a s a a a
s s s s y s s a a a a s s s s s s s s s H s s s s s s s s s s s s s s s s s s a a a a a a s s s s s p p s s s I s a a a a s s a a a s s s s s s s s s s s s s s s s s s A A s s s s s s s s s s s s s s s s s s s s s s s s p p s s s s s s s s s s s s a s s s s P s s s s s s s s s s s s s s s s s s s m m s s s s s s s s s s s s s s s s s p p s s s s s s s s a a s a a s a a a
v v v v v v v v v v v v v v v v v v v v v s s s v v v v v v v v v v v v v v v v v v v v v v v v v v v v v v v v v v v v v s s v v v v v v v v v v v v v v v v v v v v v v v v s s s s v v v v v v v v v v v v v v v v v v v v v v v v v v v v v v v s s v v v v v v v v v v v v v v v s s s s s s s v v v v v v v v v v v v v v v v v v v s s s v v s s v v v v v v v v s v v s v v v

