s s s s s s s s s s s s s s s s s s s s s s s s s s s s s s s s s s s s s s s s s s s s s s s s s s s s s s s s s s s s s s s s s s s s s s s s s s s s s s s s s s s s s s s s s s s s s s s s s s s s s s s s s s s s s s s s s s s s s s s s s s s s s s s s s s s s s s s s s s s
s s s s s s s s s s s s s s s s s s s s s s s s s s s s s s s s A A s s s s s s s s s s s s s s s s s s s s s s s s s s s s s s s s s s s s s s s s s s s s s s s s s s s s s s s s s s s s s s s s s s s s s s s s s s s s s s s s s s s s s s s s s s s s s s s s s s s s s s s s s
s s s s s s s s s s s s s s D D s s s s s s s s s s s s s s s s s s s s m s s m s s s s s s s s s s s s s s s s s s s s s s D D s s s s s s s s s s s s s s s s s s s s s s s s s s s s s s s s s s s s s s s s s s s s s s D D s s s s s s s s s s s s s s s s s s s s s s s s s s s
s s s s s s s s s s s s s s s s s s s s s B A A A s s s s s s s s s s E E E E E E E s s s s s D D s s s s s s A A A A s s s s s s s s s s p s s s s s s s s s s s s s s s s s s A A s s A A s D D s s s s s s s s s s p s s s s s s s s s s s s s s s s s s s s s s s s s s s s s s s
s s s s s s s s s s s s s s s s s s s s s E E E E E s s s s s s s O s s C C C C C s s s s s s s s s s s s s s E E E E s s s s s s s s s s K s s m s s s B p s s A A s s s s s s s s s s s s s s s s s s s s s s s s s s s s s s s s s A A s s s s s s s s s s s s s s s s s s s s a a
s s s s s s s s s s s s s s s s s s s s s s C C C s s s s s s s s s s s C C C C C s s s s A A s s s s s s s s s C C s s s s s s s s s s s s s E E E E E E s s s s s s s s s s s s s s s s s s s s s s s s s s s s s s s s s s s s s s s s s s s s s s D D s s s s s s s s s s s s a a
s s s s s s s s s s s s s s s s s s s s s s C C C s s s s s s s s s s s C C C C C s s s s s s s s s s s s s s s C C s s s s s s s s s s s s s s C C C C s s s s s s s s s s s s s s s s s s s s s s s E E E E E E E E s s s s s s s s s s s s s s s s s s s s s s s s s s s s a a a a
s s s s s s s O s s s s s s s s s s s s s s C C C s s s s s E E E E E s C C C C C s s s s s s s s s s I s s s s C C s s s s s s s s s s s s s s C C C C s s s s s D D s s s s s s s s s I s s s s s s s C C C C C C s s s s s s s s s s s s s s s O O s s s s s s s s s s s s a a a a
s s s s s s s s s s s s s s s s s s s E E E E E E E E s s s s C C C s s C C C C C s s s s s s s s s s s s s n s C C s s s s s s s E E E s s s s C C C C s s s s s s s s s s s s s D D s s s s s s s s s C C C C C C s s s s s E E E E s s E E E E s s s s s s s s s s s s a a a a a a
s s s s s s s s s s s s s s s s s s s s C C C C C C s s s I s C C C s s C C C C C s s s s s s s s s D D s s q s C C s s s s s s s s C s s s s s C C C C s s s s s s s s s s s s s s s s s s s s s s s s C C C C C C s s s s s s C C s s s s C C s s s s s s s s s s s s s a a a a a a
s s s s s s s s s s s s s s s s s s s s C C C C C C s s A s s C C C s s C C C C C s s s s s s s s s s s s s s s C C s s s s s s s s C s s s s s C C C C s s s s s s s s s s s s s s s s s E E E E s s s C C C C C C s s s s s s C C s s s s C C s s s s s s s s s s s s s a a a a a a
s s s s y s s s s s s s s E E E E s s s C C C C C C s E E E s C C C s s C C C C C s s s s s s s s s s s s s s s C C s s s s s s s s C s s s s s C C C C s s s s s s s s s s s s s s s s s s C C s s s s C C C C C C s s A A A s C C s s s s C C s s s s s s s s s n s s s a a a a a a
v v v v v v v v v v v s s s C C s s s s C C C C C C s s C s s C C C s s C C C C C s s s s E E E E s s s s s E E E E E s E E E E E s C s s s s s C C C C s s s s s s s s s s s s s s s s s s C C s s s s C C C C C C s s E E E s C C s s s s C C s s s s v v v v v v v v v v v v v v v

