s s s s s s s s s s s s s s s s s s s s s s s s s s s s s s s s s s s s s s s s s s s s s s s s s s s s s s s s s s s s s s s s s s s s s s s s s s s s s s s s s s s s s s s s s s s s s s s s s s s s s s s s s s s s s s s s s s s s s s s s s s s s s s s s s s s s s s s s s s s s s s s s s s s s s s s s s s s s s s s s s s s s s s s s s s s s s s s s s s s s s s s s s s s s s s
s s s s s s s s s s s s s s s s s s s s s s s s s s s s s s s s s s s s s s s s s s s s s s s s s s s s s s s s s s s s s s s s s s s s s s s s s s s s s s s s s s s s s s s s s s s s s s s s s s s s s s s s s s s s s s s s s s s s s s s s s s s s s s s s s s s s s s s s s s s s s s s s s s s s s s s s s s s s s s s s s s s s s s s s s s s s s s s s s s s s s s s s s s s s s s
s s s s s s s s s s s s s s s s s s s s s s s s s s s s s s s s s s s s s s s s s s s s s s s s s s s s s s s s s s s s s s s s s s s s s s s s s s s s s s s s s s s s s s s s s s s s s s s s s s s s s s s s s s s s s s s s s s s s s s s s s s s s s s s s s s s s s s s s s s s s s s s s s s s s s s s s s s s s s s s s s s s s s s s s s s s s s s s s s s s s s s s s s s s s s s
s s s s s s s s s s s s s s s s s s s s s s s s s s s s s s s s s s s s s s s s s s s s s s s s s s s s s s s s s s s s s s s s s s s s s s s s s s s s s s s s s m m s s s s s s s s s s s s s s s s s s s s s s s s s s n s s s s s s s s s s s s s s s s s s s s s s s s s s s s s s s s s s s s s s s s s s s s s s s s s s s s s s s s s s s s s s s s s s s s s s s s s s s s s s s s
s s s s s s s s s s s s s s s s s s s s s s q s s s s s s s s s s s s s s s s s s s s s s s s s s s s s s s s s s s s s s s s s s s s s s s s s s s s s s s s s h h h h h h h h s s s h h h q s s s s s s s s s s s s s s q s s s s s s s s s s s h h h s s s s h q q h s s s s s s s s s s s s s s s s s s s s s s s s s s s s s s s s s s s s s s s s s s s s s s s s s s s s s s s s a a
s s s s s s s s s s s s s s s s s s s s s s s s s s s s s s s s s s s s s s s s s s s s s s s s s s s s s s s s s s s s s s s s s s s s s s s s s s s s s s s s s s s s s s s s s s s s s s s s s s s s s s s s s s s s s s s s s s s s s s s s s s s s s s s s s s s s s s s s s s s s s s s s s s s s s s s s s s s s s s s s s s s s s s s s s s s s s s s s s s s s s s s s s s s a a a
s s s s s s s s s s s s s s s s s s s s s s s s s s s s s s s s s s s s s s s s s s s s s s s s s s s s s s s s s s s s s s s s n s s s s s s s s s s s s s s s s s s s s s s s s s s s s s s s s s s s s s s s s s s s s s s s s s s s s s s s s s s s s s s s s s s s s s s s s s s s s s s s s s s s s s s s s s s s s s s s s s s s s s s s s s s s s s s s s s s s s s s s s s a a a a
s s s s s s s s s s s s s s s s s s s s s n s s s s s s s s s s s s s s s s s s s s s s s s s s s s s s s s s s s s s s s s s s b s s s s s s s s s s s s s n s s s s s s s s s s s s s s s s s s s s s s d s s s s s s s s s s s s s s s s s s s s s s s s s s s s s s s s s s s s s s s s s s s s s s s s s s s s s s s s s s s s s s s s s s s s s s s s s s s s s s s s s s s a a a a a
s s s s s s s s s s s s s s s s q s s s h q h q h s s s s s s s s s s s s s s s s s s s s s p p s s s s s s s s s p p s s s s s s s s s s s s s s s s s s h q h s s s s s s s s s s s s s s h s s s s s h b s s s s q s s q s s q s s s s s h s s s s s s s s s s h h s s s s s s a s s a s s s s s s s s s s a a s s a s s s s s s s s s s s s h h q h s s s s s s s s s s s s a a a a a a
s s s s s s s s s s s s s s s s s s s s s s s s s s s s s s s s s s s s s s p p s s s s s s p p s s s s s s s s s p p s s s s s s s s s s s s s s s s s s s s s s s s s s s s s s s s s s s s s s s s s s s s s s s s s s s s s s s s s s s s s s s s s s s s s s s s s s s s s a a s s a a s s s s s s s s a a a s s a a s s s s s s s s s s s s s s s s s s s s s s s s s s a a a a a a a
s s s s s s s s s s s s s s s s s s s s s s s s s s s s p p s s s s s s s s p p s s s s s s p p s s s s s s s s s p p s s s s s s s s s s s s s s s s s s s s s s s s s s s s s s s s s s s s s s s s s s s s s s s s s s s s s s s s s s s s s s s s s s s s s s s s s s s s a a a s s a a a s s s s s s a a a a s s a a a s s s s s p p s s s s s s s s s s s s s s p p s a a a a a a a a
s s s s y s s s s s s s s s s s s s s s m m s s s s s s p p s s s s s s s s p p s s s s s s p p s s s s s m m s s p p s s s s s s s s s s s s s s s s s s s s s s s s s s s s s s s s s s s s n m s s s s s s s s s e s s s s s s s s s s s s s s s s m m n s n s s s s s s a a a a s s a a a a s s s s a a a a a s s a a a a s s s s p p s s s s s s s s m m m s s s p p a a a a a a a a a
v v v v v v v v v v v v v v v v v v v v v v v v v v v v v v v v v v v v v v v v v v v v v v v v v v v v v v v v v v v v v v v v v v v v v s s v v v v v v v v v v v v v v v s s s v v v v v v v v v v v v v v v v v v v v v v v v v v v v v v v v v v v v v v v v v v v v v v v v v v v v v v v v v v v v v v v v s s v v v v v v v v v v v v v v v v v v v v v v v v v v v v v v v v v v v

