s s s s s s s s s s s s s s s s s s s s s s s s s s s s s s s s s s s s s s s s s s s s s s s s s s s s s s s s s s s s s s s s s s s s s s s s s s s s s s s s s s s s s s s s s s s s s s s s s s s s s s s s s s s s s s s s s s s s s s s s s s s s s s s s s s s s s s s s s s s s s s s s s s s s s s s s s s s s s s s s s s s s s s s s s s s s s s s s s s s s s s
s s s s s s s s s s s s s s s s s s s s s s s s s s s s s s s s s s s s s s s s s s s s s s s s s s s s s s s s s s s s s s s s s s s s s s s s s s s s s s s s s s s s s s s s s s s s s s s s s s s s s s s s s s s s s s s s s s s s s s s s s s s s s s s s s s s s s s s s s s s s s s s s s s s s s s s s s s s s s s s s s s s s s s s s s s s s s s s s s s s s s s
s s s s s s s s s s s s s s s s s s s s s s s s s s s s s s s s s s s s s s s s s s s s s s s s s s s s s s s s s s s s s s s s s s s s s s s s s s s s s s s s s s s s s s s s s s s s s s s s s s s s s s s s s s s s s s s s s s s s s s s s s s s s s s s s s s s s s s s s s s s s s s s s s s s s s s s s s s s s s s s s s s s s s s s s s s s s s s s s s s s s s s
s s s s s s s s s s s s s s s s s s s s s s s s s s s s s s s s s s s s s s s s s s s s s s s s s s s s s s s s s s s s s s s s s s s s s s s s s s s s s s s s s s s s s s d s s s s s s s s s s s s s s s s s s s s s s s s s s s s s s s s s s s s s s s s s s s s s s s s s s s s s s s s s s s s s s s s s s s s s s s s s s s s s s s s s s s s s s s s s s s s s s s
s s s s s s s s s s s s s s s s s s s s s s s s s s s s s s s s s s s s s s s s s s s s s s s s s s s s s s s s s s s s s s s s s s s s s s s s s s s s s s s s s s s s s h b h s s s s s s s s s s s s s s s s s s s s s s s s s s s s s s s s s s s s s s s s s s s s s s s s s s s s s s s s s s s s s s s s s s s s s s s s s s s s s s s s s s s s s s s s s s s s s s
s s s s s s s s s s s s s s s s s s s s s s s s s s s s s s s s s s s s s s s s s s s s s s s s s s s s s s s s s s s s s s s s s s s s s s s s s s s s s s s s s s s s s s s s s s s s s s s s s s s s s s s s s s s s s s s s s s s s s s s s s s s s s s s s s s s s s s s s s s s s s s s s s s s s s s s G G s s s s s s s s s s s s s s s s s s s s s s s s s s s s s
s s s s s s s s s s s s s s s s s s s s s s s s s s s s s s s s s s s s s s s s s s s s s s s s s s s s s s s s s s s s s s s s s s s s s s s s s s s s s s s s s s s s s s s s s s s s s s s s s s s s s s s s s s s s s s s s s s s s s s s s s s s s s s s s s s s s s s s s s s s s s s s s s s s s s s s p p s s s s s s s s s s s s s s s s s s s s s s s s s s s s s
s s s s s s s s s s s s s s s s s s s s s s s s s s s s s s s s s s s s s s s s s s s s s s s s s s s s s s s s s s s s s s s s s s s s s s s s s s s s s s s s s s s s s s s s s s s s s s s s s s s s s s s s s s s s s s s s s s s s s s s s s s s s s s s s s s s s s s s s s s s s s s s n s s s s s s s p p s s s s s s s s s s s s s s s s s s s s s s s s s s s s a
s s s s s s s s s s s s s s s s s s s s s s s s s s s s s s s s s s s s s s s G G s s s s s G G s s s s s s s s s s s s s s s s s s s s s s s s s s s s s s A s s s s s a a a a a s s s s s s s s s s s s s s s s s s s s s s s s s s s s s s s s s s s s s s s s s s s s s s s s s s s s s a b h h s s s s s a a s s s s s s s s s s s s s s s s s s s s s s A s s s s a a
s s s s s s s s s s s s s s s s s s s s s s s s s s s s s s s s s s s s s s s p p s s s s s p p s s s s I s s s s s s s s s s s s s s s s s s s s s s s s s m s s s s s a s s s s s s s s s s s s s s s s s s s s s s s s s s a s s s s s s s s s s s s s s s s s s s s s s s s s s s s s s a s s s s s s s s s s s s s s s G G s s s s s s s s s s m s s s s G s s s a a a
s s s s s s s s s s s s s s s s s s s s s s s s s s s s s s s s s s s s s s s p p s s s s s p p s s s s s s s s s s s s s s s s s s s s s s s s s s s s s s s s s s s s a s s s s s s s s s s s s s s s s s s s O O s s s s s a s s s s s s s s s s s s s s s s s s s s s s s s s s s s G s a s s s s s s s s s O O s s s s p p s s s O O s s s s s s s s s s s s s a a a a
s s s s y s s s s s s s s m m s s s s s s s s m m m m m s s s s m s s s s s s p p s s s s s p p s s s s s s s s s s m s s m s s s s s m m m m s s s s s s s s s s s s s a s s s s s s s s s s s s I s m m s s s s s n s s s s a s s s s m m s s s e s s s s s s n s s s s s s s s s s B G s a s s s s s s s s s s s n s s s p p s s s s s n s s s s s s s s s s s a a a a a
v v v v v v v v v v v v v v v v v v v v v v v v v v v v v v v v v v v v v v v v v v v v s s v v v v v v v v v v v v v v v v v v v v v v v v v v v v v v v v v v v v v v v v v s s s s v v v v v v v v v v v v v v v v v v s s v v v v v v v v v v v v v v v v v v v v v v v v v v v v v v v v v v v v s s s v v v v v v v v v v v v v v v v v v v v v v v v v v v v v v v v

