s s s s s s s s s s s s s s s s s s s s s s s s s s s s s s s s s s s s s s s s s s s s s s s s s s s s s s s s s s s s s s s s s s s s s s s s s s s s s s s s s s s s s s s s s s s s s s s s s s s s s s s s s s s s s s s s s s s s s s s s s s s s s s s s s s s s s s s s s s s s s s s s n s s s s s s s s s s s s s s s s s s s
s s s s s s s s s s s s s s s s s s s s s s s s s s s s s s s s s s s s s s s s s s s s s s s s s s s s s s s s s s s s s s s s s s s s s s s s s s s s s s s s s s s s s s s s s s s s s s s s s s s s s s s s s s s s s s s s s s s s s s s s s s s s s s s s s s s s s s s s s s s s s s s s b s s s s s s s s s s s s s s s s s s s
s s s s s s s s s s s s s s s s s s s s s s s s s s s s s s s s s s s s s s s s s s s s s s s s s s s s s s s s s s s s s s s s s s s s s s s s s s s s s s s s s s s s s s s s s s s s s s s s s s s s s s s s s s s s s s s s s s s s s s s s s s s s s s s s s s s s s s s s s s s s s s s s s s s s s s s s s s s s s s s s s s s s
s s s s s s s s s s s s s s s s s s s s n s s s s s s s s s s s s s s s s s s s s s s s s s s s s s s s s s s s s s s s s s s s s s s s s s s s s s s s s s s Q s s s s s s n s s s s s s s s s s s s s s s s s s s s s s s s s s s s s s s s s s s s s s s s s s s s s s s s s s s s s s s s s s s s s s s s s s s s s s s s s s s s s
s s s s s s s s s s s s s s s s s s s s b h h s s s s s s s s s s s s s s s s s s s s s s s s s s s s s s s s s s s s s s s s s s s s s s s s s s s s h h h h h h h s s s s b s s s s s s s s s s s s s s s s s s s s s s s s s s s s s s s s s s s s s s s s h h h h h s s s s s s s s s s s s s s s s s s s s s s s s s s s s s s a a
s s s s s s s s s s s s s s s s s s s s s s s s s s s s s s s s s s s s s s s s s s s s s s s s s s s s s s s s s s s s s s s s s s s s s s s s s s s s s s s s s s s s s s s s s s s s s s s s s s s s s s s s s s s s s s s s s s s s s s s s s s s s s s s s s s s s s s s s s s s s s s s s s s h h s s s s s s s s s s s s e a a a
s s s s s s s s s s s s s s s s s s s s s s s s s s s s s s s s s s s s s s s s s s s s s s s s s s s s s s s O O s d s s s s s s s s s s s s s s s s s s s s s s s s s s s s s s s s s s s s s s s s s s s s s s s s s s s s s s s s s s s s s s s s s s s s s I s s s s s s s s s s s s s s s s s s s s s s a s s s s s s s s a a a a
s s s s s s s s s s s s s s s s s s s s s s s s s s s s s s s s s s s s s s s s s s s s s s s s s s s s s s s s s s s s s s s s s s s s s s s s s s s s s Q s s s s s s s s s s s s s s s s s s s s s s s s s s s s s s s s s s s s s s s s s s s s s s s s s s Q s s s s s s s s s s s s s h h s s s s s s a a s s s s s s s a a a a a
s s s s s s s s s s s s s s s s s I s s s s s s s s s s s s s s q q q q s s s s s s s s s s s s s s s s s s s h h a b h s s s s s s s s s G G s s s s h h h h h h h s s s s G G s s s s s s s s s s s s s s G G s s s s s s s s s s s s s s s s s s s s s s s h h h h h s s s s s s s s s s s s s s s s s a a a s s s s s s a a a a a a
s s s s s s s s s s s s s s s s G m s O O s s s s s s s s s s s s s s s s O O s s s s s s s s O O s s s s s s s s s s s s s s s s s s s s p p s s s s s s s s s s s s s s s p p s s s s s s s s s s s s s s p p s s s s G G s s s s s s s s s s s G G s s s s s s I s s s s a s s O O s s s s s s s s s a a a a s s s s s a a a a a a a
s s s s s s s s s s O O s s s s s s s s s s s s s s s O O s s I s s s s s s s s s s s s Q s s s s s s s s s s s s s s O O s s s s s s s s p p s s s s s s s s s s s s s s s p p s s s s s s s O O s s s s s p p s s s s p p s s s O O s s s s s s p p s s s s s s s s s s s a s s s s s s s s s H s s a a a a a s s s s a a a a a a a a
s s s s y s s s s s s s s s s s s s s O O s s s s s s s s s s s s s s s s s s s s s s s s s s O O s s s s s s s s s s s s s s s s s s s s p p s s s s s s s s s s s s s s s p p s s s s s s s s s s s s s s p p s s s s p p s s s s s s s s s s s p p s s s s s s s s s s s a s s O O s s s s s H s a a a a a a s s s a a a a a a a a a
v v v v v v v v v v v v v v v v v v v v v v v v v v v v v v v v v v v v v v v v v v v v v v v v v v v v v v v v v v v v v v v v v v s s v v v v v v v v v v v v v v v v v v v v v v v v v v v v v v v v v v v v v v v v v v v v v v v v v v v v v v v v v v v v v v v v v v v v v v v v v v v v v s v v v v v v v v v v v v v v v v v v

