s s s s s s s s s s s s s s s s s s s s s s s s s s s s s s s s s s s s s s s s s s s s s s s s s s s s s s s s s s s s s s s s s s s s s s s s s s s s s s s s s s s s s s s s s s s s s s s s s s s s s s s s s s s s s s s s s s s s s s s s s s s s s s s s s s s s s s s s s s s s s s s s s s s s s s s s s s s s s s s s s s s s s s s s s s s s s s s s s s s s s s s s s s s s s s s s s s s s s s s s s s s
s s s s s s s s s s s s s s s s s s s s s s s s s s s s s s s s s s s s s s s s s s s s s s s s s s s s s s s s s s s s s s s s s s s s s s s s s s s s s s s s s s s s s s s s s s s s s s s s s s s s s s s s s s s s s s s s s s s s s s s s s s s s s s s s s s s s s s s s s s s s s s s s s s s s s s s s s s s s s s s s s s s s s s s s s s s s s s s s s s s s s s s s s s s s s s s s s s s s s s s s s s s
s s s s s s s s s s s s s s s s s s s s s s s s s s s s s s s s s s s s s s s s s s s s s s s s s s s s s s s s s s s s s s s s s s s s s s s s s s s s s s s s s s s s s s s s s s s s s s s s s s s s s s s s s s s s s s s s s s s s s s s s s s s s s s s s s s s s s s s s s s s s s s s s s s s s s s s s s s s s s s s s s s s s s s s s s s s s s s s s s s s s s s s s s s s s s s s s s s s s s s s s s s s
s s s s s s s s s s s s s s s s s s s s s s s s s s s s s s s s s s s s s s s s s s s s s s s s s s s s s s s s s s s s s n d s s s s s s s s s s s s s s s s s s s s s s s s s s s s s s s s s s s s s s s s s s s s s s s d n s s s s s s s s s s s s s s s s s s s s s s s s s s s s s s s s s s s s s s s s s s s s s s s s s s s s s s s s s s s s s s s s s s s s s s s s s s s s s s s s s s s s s s s s s s s
s s s s s s s s s s s s s s s s s s s s s s s s s s s s s s s s s s s s s s s s s s s s s s s s s s s s s s s h h h h h h b h s s s s s s s s s s s s s s s s s s s s s s s s s s s s s s s s s s s s s s s s s s s s s s s h b h h h h h h s s s s s s s s s s s s s s s s s s s s s s s s s s s s s s s s s s s s s s s s s s s s s s s s s s s s s s s s s s s s s s s s s s s s s s s s s s s s s s s s s a a s s
s s s s s s s s s s s s s s s s s s s s s s s s s s s s s s s s s s s s s s s s s s s s s s s s s s s s s s s s s s s s s s s s s s s s s s s s s s s s s s s s s s s s s s s s s s s s s s s s s s s s s s s s s s s s s s s s s s s s s s s s s s s s s s s s s s s s s s s s s s s s s s s s s s s s s s s s s s s s s s s s s s s s s s s s s s s s s s s s s s s s s s s s s s s s s s s s s s s s s s s s s s s
s s s s s s s s s s s s s s s s s s s h h h h h h h h s s s s s h h h h h h h h h h h h h h s s s s s s s s s s s s s G s s s s s s s s s s s s s s h h h h h h s s s h h h h h h s s s h h h h h h h h h h s s s s s s s s s s s s s s s s s s s s s s s s s h h h h h h h h h h h h h h h h h h h h h h h h h h h h h h h h h h s s s s s s h h h h h h h h h h h h h h h h h h h h s s s s s s s s s s a s s s s s
s s s s s s s s s s s s s s s s s s s h h h h h h h h s s s s s h h h h h h h h h h h h h h s s G G s s s s s s s s s Q s s s s s s s s s s s s s s h h h h h h s s s h h h h h h s s s h h h h h h h h h h s s s s s s s s s s s s s Q s s s s s G G s s s s h h h h h h h h h h h h h h h h h h h h h h h h h h h h h h h h h h s s s s s s h h h h h h h h h h h h h h h h h h s h s s s s s s s s s s s s s s s s
s s s s s s s s s s s s s s s s s s s h h h h h h h h s s s s s h h h h h h h h h h h h h h s s p p s s s s s h h h h h h h h s s s a s s s s s s s h h h h h h s s s h h h h h h s s s h h h h h h h h h h s s a a s s s s h h h h h h h h s s s p p s s s s h h h h h h h h h h h h h h h h h h h h h h h h h h h h h h h h h h s s G G s s h h h h h h h h h h h h h h h h h h b h s s s s s s s s a s s s s s s s
s s s s s s s s s s s s s s s s s s s h h h h h h h h O O s s s h h h h h h h h h h h h h h s s p p s s s s s s s s s s s s s s s s a a s s s s s s h h h h h h s s s h h h h h h s a s h h h h h h h h h h s s a a s s s s s s s s s s s s s s s p p s s s s h h h h h h h h h h h h h h h h h h h h h h h h h h h h h h h h h h s s p p s s h h h h h h h h h h h h h h h h h h h h s s s s s s s s s s s s s s s s
s s s s s s s s s s s O O s s s s s s h h h h s h h h s s s s s h h h h h h h h h h h h h h s s p p s s s s s s s s s s G s s s s s a a a s s s s s h h h h h h O s s h h h s h h s a s h h h h h h h h h h s s a a s s s s s s s s s s s s s s s p p s s s s h h h h h h h h h h h h h h h h h h h h h h h h h h h h h h h h h h s s p p s s h h h h h h h h h h h h h h h h h h h h s s s a s s a s s s s s s s s s
s s s s y s s s s s s s s s s s s s s h h h h h h h h s s s s s h h h h h h h h h h h h h h s s p p s s s s s s s s s s s G s s s s a a a a s s s s h h h h h h s s s h h h h h h s a s h h h h h h h h h h s s a a s s s s s s s n s s s s s s s p p s s s s h h h h h h h h h h h h h h h h h h h h h h h h h h h h h h h h h h s s p p s s h h h h h Q h h h h h h h h h h h h h h s s s a s s s s s s s s s s s s
v v v v v v v v v v v v v v v v v v v v v v v v v v v v v v v v v v v v v v v v v v v v v v v v v v v v v v v v v v v v v v v v s s v v v v s s v v v v v v v v v v v v v v v v v v v v v v v v v v v v v v v v v v v v v v v v v v v v v v v s s v v s s v v v v v v v v v v v v v v v v v v v v v v v v v v v v v v v v v v v v v v v v v v v v v v v v v v v v v v v v v v v v v v v v v v v s s s s s s s s s s s

